07 07 07 07 07 07 07 07 07 07 07 07 07 07 03 06
01 08 00 08 08 00 08 08 00 08 08 00 08 08 04 05
01 14 09 06 03 12 11 10 04 11 10 04 11 10 04 05
01 14 03 12 09 06 11 10 04 11 10 04 11 10 04 05
01 14 01 10 10 08 10 14 05 03 02 04 11 10 00 04
01 14 05 03 10 10 10 06 13 05 05 05 03 02 04 05
01 14 05 05 03 10 02 08 14 05 05 05 05 05 05 05
01 14 05 05 05 15 05 03 06 13 05 13 05 05 05 13
01 02 08 08 00 10 12 09 08 10 12 03 04 05 01 06
05 05 03 14 05 07 07 07 07 03 06 05 05 05 05 05
09 00 12 03 12 05 05 01 00 04 09 12 05 05 13 05
07 13 03 08 10 08 00 12 13 09 10 10 04 05 07 05
01 10 04 07 07 07 05 07 03 14 03 14 05 05 05 05
01 06 05 05 05 05 13 05 05 15 05 03 08 12 05 05
05 05 09 04 05 09 10 12 09 14 13 09 10 14 05 05
13 09 10 08 08 10 10 10 10 10 10 10 10 10 08 12
